##############################
#     #       #         #   ##
# ### # ##### ##### ### ### ##
# #   #     #     #   #   # #
# # ####### ##### ### ### # #
# #       #     #     #   # #
### ##### ##### # ##### ### #
#   #   #     # # #   #     #
# ### # ### ### # # ### #####
#     #   #     # #     #   #
##### ### # ##### ### ### # #
#     # # # #     #     # # #
### # # # ### ##### ### # ###
#   #   #     #     #   #   #
# ### ##### ##### ### ##### #
# #     #     # B   #     # #
# # ### ### ### ##### ### # #
#   # #     #     #     #   #
### # # ### ##### ##### ### #
#   #   #   #   #     #     #
# ##### # ### # ### ##### ###
#     # #     #   #       # #
### ### ##### ### ##### ### #
#   #       #     #     #   #
# ### ##### ### ### ### ### #
#     #     #   #     #     #
### ##### ### ### ### ### ###
#     #     #   #   #     # #
# ### ### ##### ### ### ### #
A   #               #       #
##############################
