####################
##    ##    ##    ##
## ## ## ## ## ## ##
## ##    ##    ## ##
## ############## ##
## ##    ##    ## ##
## ## ## ## ## ## ##
##          ##    ##
###### ####### ##  #
#                #B#
## ## ## ## ## ## ##
## ## ## ## ## ## ##
##    ##    ##    ##
###### ########## ##
##          ##    ##
## ## ## ## ## ## ##
## ## ## ## ##### ##
##                 #
##################A#
