###########################B#
#   #     #     #   #   #   #
# # # ### ##### # ### ### # #
# #   #   #   # #     #   # #
# ##### ### # ##### ### ### #
#     #     # #     #     # #
### ### ##### ### ##### ### #
#   #   #   #   #   #   #   #
# ### ### ### ##### ### ### #
#     #     #   #     #   # #
# ### ##### ### ### ##### # #
#   # #     #   #     #   # #
### # ### ### ### ### ##### #
#   #   #     #   #   #     #
##### ### ### ### ### ### # #
#     #   #   #   #     #   #
### ##### ### ##### ##### # #
#   #     #     #   #     # #
# ##### ### ### ### ### ### #
#     #     #   #     #     #
##### ### ### ##### ### ### #
#     #   #   #   #   #   # #
# ### ##### ### ### ### ### #
#   #     #   #   #     #   #
### ### ##### ### ### ### # #
#     #     #     #     #   #
##### ### ### ### ##### ### #
#   #     #   #     #     # #
# ### ##### ### ### ##### # #
A                           #
#############################
