#####A########################
#   #     #     #       #   #
# ### ### # ### ### ### ### #
#   #   # #   #   #   #     #
##### ### ### ### ### ##### #
#     #                     #
# ### ##### ### ##### ### ###
#   #   #   #   #   #   #   #
# # ### ### ### ### ### # # #
# # #   #             # # # #
# # # ### ### ### ### # # # #
# #     #   #     #   # # # #
### ### ### # ### # ### # # #
#     #     #   #           #
##### ### ##### ### ####### #
#     #   #     #     #     #
### ### ### ### ### ### ### #
#   #     #   #   #   #     #
# # ### ### ### ### ### ### #
# #   #     #     #     #   #
# ##### ### ### ##### ### # #
#     #   #   #     #       #
##### ### ### ### ### ### # #
#   #     #     #   #     # #
# # ##### ### ### ### ##### #
# #   #     #   #   #       #
# ### ### ### ##### ### ### #
#     #   #     #     #   # #
##### ### ##### ### ##### # #
#                         #B#
##############################
