A     #     #   #       #   #
# ### ### ### ### ### ### ###
#   #     #   #   #   #   # #
### ##### ### ### ### ### # #
#     #     #     #   #   # #
### ### ### ### ### ### # # #
#   #     #   #   #   # # # #
# # ### ### ### ### # # # # #
# #     #     #     # # # # #
# ### ### ##### ##### ### # #
#   #   #   #     #     #   #
##### ### ### ### ### ### ###
#   #     #   #   #     #   #
# ### ### ### ### ##### ### #
#     #     #     #     #   #
### ### ### ### ### ### # ###
#   #     #   #   #   # #   #
# ### ##### ### ##### ##### #
#   #   #   #     #     #   #
# ### ### ##### ### ### # ###
#   #     #     #     # #   #
### ### ### ### ### ### ### #
#     #     #   #     #     #
### ##### ### ### ##### ### #
#     #   #     #   #   #   #
# ##### ### ##### ### ### # #
#     #     #   #     #   # #
### ### ### ### ### ### # ###
#     #   #   #   #   # #   #
########################## B#
