A ########
    #     #
# # # ### #
# #   #   #
# ##### ###
#     #   #
### ### ###
#   #     #
# ### ##### 
#       B #
###########