##############################
#   #       #   #     #     B
# # # ##### # # # ### ### ###
# #     #   # #   #   #   # #
### ### # ### ##### ### # # #
#   #   #     #     #   # # #
# # ##### ### ### ### ### # #
# #   #     #   #   #   # # #
# ### ### ### ### ### # # ###
#     #   # #   #   # # #   #
##### ### # # ### ### ### ###
#     # #   #   #   #   #   #
# ### ##### ### ### ### # ###
#   #     # #     #     #   #
# # ##### # ### ### ##### ###
# #     #     #   #     #   #
# ##### ### ### ##### ### ###
#     #   #   #     # #     #
### ##### ### ### # ##### ###
#     #     #     #       # #
# ### ### ### ### ##### ### #
#   #     #     #     #   # #
### ### ### ### ### ### # # #
#     #   #   #     #   # # #
# ### # ### ### ### ##### # #
#   # #     #     #     # # #
# # # ### ### ### ##### ### #
# #   #     #   # #   #     #
# ##### ### ### # # ### #####
A       #         #         #
##############################
